25 20
x 1 0 0 1 0 0 e 0 0 0 0 0 e 0 0 0 0 0 0 0 e 0 1 0
0 1 0 0 1 1 0 0 0 0 0 0 0 0 0 0 0 1 1 0 0 0 0 1 0
0 0 0 0 0 1 0 0 0 0 0 0 0 0 0 1 1 0 0 0 0 1 0 1 0
0 1 1 1 0 0 0 0 1 1 0 e 1 0 0 0 0 0 0 0 0 1 1 1 0
0 0 1 1 0 1 0 0 1 1 0 0 1 0 0 0 0 0 1 0 0 0 0 0 0
0 0 0 e 0 1 1 0 0 0 0 0 1 0 0 0 0 0 1 0 0 1 1 1 0
1 1 1 0 1 1 0 e 0 0 0 1 1 1 1 e 0 0 1 0 e 0 1 0 e
0 0 e 0 1 e 0 0 0 0 0 0 0 0 0 0 0 0 1 0 0 0 1 0 0
0 0 0 0 0 0 1 1 1 1 0 0 e 0 1 0 0 0 1 e 0 0 1 1 1
0 0 e 0 1 0 0 0 0 1 0 1 0 0 1 1 1 0 0 0 0 1 1 1 1
0 0 1 0 0 e 0 0 0 0 e 0 0 0 0 0 0 0 1 0 0 e 0 0 0
0 0 1 0 0 e 0 e 1 0 1 1 1 1 0 0 0 1 0 0 0 0 0 0 e
0 0 1 0 0 e 0 0 0 1 0 0 0 0 0 e 0 0 1 1 1 e 0 0 0
0 0 1 0 0 0 0 0 0 1 0 1 e 1 0 0 0 0 e 0 1 0 e 0 0
0 0 1 0 1 1 1 1 0 1 0 0 0 1 1 1 1 e 0 0 1 0 e 0 0
0 0 0 0 0 0 0 0 0 1 1 1 0 e 0 0 1 0 0 0 0 e 0 0 0
0 0 0 0 1 0 1 1 0 0 0 1 1 1 1 0 1 0 0 0 0 0 e 0 0
1 1 1 0 1 0 1 1 0 1 0 1 g e 1 0 1 1 1 1 1 0 0 0 0
0 0 1 0 0 0 0 0 e 1 0 1 0 0 1 0 1 0 0 0 0 0 0 e 0
0 0 1 0 0 e 0 0 0 1 0 0 0 0 0 0 1 0 0 0 0 0 0 0 e